....................
....................
..X.................
..#####.............
.............B.GGG..
.F...........#####..
-----...............
..........S.........
........#####.......
.GGGA...............
.#####..............
....................
....................
.1..................
####################
