....................
....................
....................
....................
GGGS................
#####...............
...------....GGG....
...........#####....
..G.F.G.............
..-----.............
............G.G.....
...........-----....
....................
.1...............X..
####################
