....................
.X..................
##--................
....................
---------...........
.............G.G.G.G
.............#######
........GGG.........
......######........
G..G................
---##...............
................GGG.
...............#####
.1..................
####################
