....................
....................
..X.................
..#####.............
...............GGG..
....------...#####..
....................
....................
........#####.......
.GGG................
.#####..............
....................
....................
.1..................
####################
