....................
....................
........GGGG........
.......######.......
S.G..............X..
####....----...-----
....................
......--------......
...--...........--..
....................
.F.G............G.G.
##--............----
....................
.1..................
####################
